XXXXXXXXXXXXXGX
XEEEEEEEEEEEEEX
XXXEXXXXXXXXXXX
XXXEXXXXXXXXXXX
XXXEXEEEEEEEEEX
XXXEXXXXXEXXXXX
XXXEXXXXXEXXXXX
XXXEXXXXXEXXXXX
XXXEXXXXXEXXXXX
XXXEXXXXXEXXXXX
XXXEEEEEEEXXXXX
XXXEXXXXXEXXXXX
XXXEXXXXXEXXXXX
XXXEXXXXXEXXXXX
XXXSXXXXXXXXXXX
